111111111111111111111111111111111111111111111111
100010000000000000000000100000000000000001111111
1000100000C0000000000000100000000000000000000E11
1000100000100000000000001000000000000C0001111111
1C0010000000000000000000100000000000010000000001
110010000000000000000000100000000000000000000001
10001111111000C00C000000100000000000000000C00001
100000000010001001000000100000000000000000110001
10000000001000C01111111110000000000000000000C001
100000000010001010000000000000000000000000001001
100000C00010000P10000000000000000000000000000001
100000100010000110000000000000001111111111111111
100C0000001000000000C0000000000011000000100000C1
1001000000000000000011000011111011C0000010111111
111111110000011111111111101101100110000010000001
100000000000000000000001001100100011000011111101
1000000000000C0000000010000110000001100010000101
100C0000000001000C000100000011000000110000110101
100100000000000001001000001001101111110010010101
1000000C0000000000010000001101101100001111010101
100000010000000000100000001111101101001000010101
100000000000000001000000000000000001011101110001
100C00000000000010000000000C0C000001010001010101
10010000000000C100000000000111000001000100010101
111111111111111111111111111111111111111111111111
